####################
@                  #
# CTTTTTT         C#
#TTTTTTTT   TTMTTTT#
#CM TTTTTT   TMTTTT#
#M  TTTTTT  TTCTTTT#
#             TTTTT#
#TTTTTTTTTT TTTTTTT#
#TTTTTTTT   TTTTTTT#
#        M M       #
#         B        #
#      WWWEWWW     #
#WWWWWW      WWWWWW#
####################
