####################
@                  #
# CTTTTTT         C#
#TTTTTTTT   TT$TTTT#
#C$ TTTTTT   T$TTTT#
#$  TTTTTT  TTCTTTT#
#             TTTTT#
#TTTTTTTTTT TTTTTTT#
#TTTTTTTT   TTTTTTT#
#        $ $       #
#         $        #
#      WWWDWWW     #
#WWWWWW      WWWWWW#
####################
