WWWWWWWWWDWWWWWWWWWW
W CKC W    W   P   W
WWMMMWW    W   B   W
W   MMW    WWWWDWWWW
W     D    W       W
WWWWWWW    W       W
W         ML       W
W      @   W       W
WWWWWWWSWWWWWWWWWWWW