WWWWWWWWWDWWWWWWWWWW
W CKC W    W   P   W
WW$$$WW    W   &   W
W   $$W    WWWWDWWWW
W     D    W       W
WWWWWWW    W       W
W         $L       W
W      @   W       W
WWWWWWWSWWWWWWWWWWWW