WWWWWWWSWWWWWWWWWW
W       W  $   $ W
W WWWWWWW WWWWWW W
W    $    W    C W
WWWWWWWWWWW WWWWWW
WC P  $   D      W
WC   &    W      S
WWWWWWWWWWWWWWWWWW
